###############
#A      #     #
# ##### # ### #
#     # #   # #
##### # ### # #
#   # #     # #
# # # ##### # #
# # #   #   # #
# # ### # ### #
#     #     B #
###############
